NO ./textures/north_wall.png
SO ./textures/south_wall.png
WE ./textures/west_wall.png
EA ./textures/east_wall.png

F 0,0,0
C 255,255,255

        111111111111111111111111111111111111111111111111111111111
1111111110000000011111111111111111110000000000000000000001
111111111111000000000001111110000000000000000011111111111
100000000000000000000000000000000000000000000000000000001111111111111111111111
100000000000000000000000000000000000000000000000000000000000000000000000000001
10000000000000000000000000000000000000000000000000000000000000000000000W000001
100000000000000000000000000000000000000000000000000000000000000000000000000001
100000000000000000000000000000000000000000000000000001111111111111111111111111
100000000000000000000000000000000000000000000000000000001
100000000000000000000000000000000000000000000000000000001
111111111111111111111111111111111111111111111111111111111