NO ./textures/north_wall.png
SO ./textures/south_wall.png
WE ./textures/west_wall.png
EA ./textures/east_wall.png

F 220,111,119
C 225,111,0

 1111111111111111111111
100000000000S00000000001
 1000000000000000000001
  10000000000000000001
   100000000000000001
    10000000W0000001
     10000000000001
      100000000001
       1000000001
        10000001
         101101
          1001
           11
