111111111111111111111111111111111111111111111
100000000000000000000000000000000000000000001
100000000000000000000000000000000000000000001
100000000000000000000000000000000000000000001
100000111111111111111111111111111100000000001
100000100000000000000000000000000100000000001
100000100000000000000000000000000100000000001
100000100000011111111111110000000100000000001
100000100000010000000000010000000100000000001
100000100000010000000000010000000100000000001
100000100000010000000000010000000111111000001
100000100000010000000N00010000000000001000001
100000100000010000000000010000000000001000001
100000100000010000000000010000000000001000001
100000100000011111000111110000000000001000001
100000100000000001000100000000000000001000001
100000100000000001000100000000000000001000001
100000100000000001000100000000000000001000001
100000100000000001000100000000000000001000001
100000100000000001000100000000000000001000001
100000100000000001000100000000000000001000001
100000100000000001000100000000000000001000001
100000100000111111000111111111111111111000001
100000100000100000000000000000000000000000001
100000100000100000000000000000000000000000001
100000100000100000000000000000000000000000001
100000111111111111111111100000000000000000001
100000000000000000000000100000000000000000001
100000000000000000000000100000000000000000001
100000000000000000000000100000000000000000001
100000000000000000000000100000000000000000001
100000011111111111111111100000111111111111111
100000010000000000000000000000100000000000001
100000010000000000000000000000100000000000001
100000010000000000000000000000100000000000001
100000010000000000000000000000100000000000001
100000010000000000000000000000100000000000001
100000010000000000000000000000100000000000001
100000011111111111111111111111100000000000001
100000000000000000000000000000000000000000001
100000000000000000000000000000000000000000001
100000000000000000000000000000000000000000001
111111111111111111111111111111111111111111111